R 1921 1082
NO ./path_to_the_north_texture_end
SO ./path_to_the_south_texture_end
WE ./path_to_the_west_texture_end


EA ./path_to_the_east_texture_end


S ./path_to_the_sprite_texture_end


F 220,100,0
C 225,30,0

        1111111111111111111111111
        1000000000110000000000001
        1011000001110000002000001
        1001000000000000000000001
111111111011000001110000000000001
100000000011000001110111111111111
11110333333333011100000010001
11110333333333011101010040001
11000000330301011100000040001
10002000000000001100000030001
10000000000000001101010030001
11000001110101011111011120N0211
11110111 1110101 101111010001
11111111 1111111 111111111111




