R 840 680
NO ./tax/zavala.xpm
SO ./tax/wall_s.xpm
WE ./tax/wall_w.xpm


EA ./tax/wall_e.xpm


S ./tax/tree.xpm


F 220,100,0
C 255,255,255

1111111111111111111111
1200001000020000000001
1000000000000001111111
1000000000000001
1000000000000001
1000000N00000001
1000000000000001
1000000000000001
1000000000000001
1111111111111111



