R 900 800
NO ./tax/brick.xpm
SO ./tax/grey.xpm
WE ./tax/wood.xpm


EA ./tax/blue.xpm


S ./tax/tree.xpm


F 220,100,0
C 255,255,255

        1111111111111111111111111
        1000000000110022222222001
        1011000001110000000000001
        1001000000000000000000001
111111111011000001110000000000001
100000000011000001110111000011111
11110111111111011100000000201
11110111111111011101010010201
11000000110101011100000010201
10002000000000001100000010201
10000000000000001101010010201
11000001110101011111011110N0111
11110111 1110101 101111010001
11111111 1111111 111111111111



