R 800 600
NO ./tax/town_1.xpm
SO ./tax/town_2.xpm
WE ./tax/town_3.xpm


EA ./tax/town_4.xpm


S ./tax/pillar.xpm


F 220,100,0
C 255,255,255

        1111111111111111111111111
        1000000000110022222222001
        1011000001110000000000001
        1001000000000000009000001
111111111011000001110000009000001
100000000011000001116543009011111
11110111111111011100000000901
111101111111110111088MM888901
11000000110101011100088880001
1000M000000000001100088880001
10000000000000001101010000001
11000001110101011111011110N0111
11110111 1110101 101111010001
11111111 1111111 111111111111



