R 800 600
NO ./tax/town_1.xpm
SO ./tax/town_2.xpm
WE ./tax/town_3.xpm


EA ./tax/town_4.xpm


S ./tax/pillar.xpm


F 220,100,0
C 255,255,255

        1111111111111111111111111
        1000000000110022222222001
        1011009001110000700000001
        1001009080008000000000001
111111111011000001110000000700001
1M0000000M11000001110000000011111
1111011111111101117000M000001
11110111111111011100000000M01
11000000110101011170000000001
1000M000000000001100M00000001111111111
10000000009000001101010000001333333331
11000001110101011111011110N05000000641
11110111 1110101 101111010001333333331
11111111 1111111 111111111111111111111



